//####///
###  ####
#     $ #
# #   $ #
# . . @ #
#########