//////////
/########/
/#  @   #/
/#      #/
/# $  $ #/
/#      #/
/# .  . #/
/########/
//////////