/////////////////////
/////#####///////////
/////#   #///////////
/////#$  #///////////
///###  $##//////////
///#  $ $ #//////////
/###      #///######/
/#         ###   ..#/
/# $  $          ..#/
/##### ### #@##  ..#/
/////#     #########/
/////#######/////////
/////////////////////